5,5,
1,1,1,1,1,
1,3,0,0,1,
1,0,4,5,1,
2,2,6,7,1,
1,1,1,1,1,
